1 99
 ###########
##         #
#     $    #
# $        #
#. @      .#
############