1 99
###############
##     #     ##
#  $  #  $   ##
#     #       #
#  +  #  .    #
##         ####
###############
