1 99
###############
##           ##
#  $  #  $  # #
#     #     # #
#  .  #  @  # #
##       #   ##
###############
