1 99
###############
##           ##
#  $  #  $   ##
#     #      ##
#  .  #  +   ##
##       #   ##
###############
