1 99
###############
#     #       #
#  .      $   #
#  #  #   #   #
#  @   $  .   # 
###############
