1 99
###############
#     #       #
#  .  #   $   #
#  #  #   #   #
#  @   $  .   # 
###############
