1 99 59
###############
##   #   .   ##
# $   #  $   ##  
#  @   #     ##  
#     # . $  ##  
##   .##   ####    
###############  
