1 99
###############
# *     #     #
#   #  #  $   #
#     #   #   #
#   .    @   ## 
##    ##     ##
###############
