1 99
###############
# .     #     #
# $  #  #  $  #
#     #   #   #
#   .    @   ## 
##    ##  .  ##
###############
