1 99
 ###########
##         #
#          #
# $ $  .   #
#. @       #
############