1 99
###############
# .     #     #
# $  #  #  $  #
#     #   #   #
#   .    @   ## 
##    ##     ##
###############
