1 99
###############
##     #     ##
#  $  #  $   ##
#     #       #
#  @  #  .    #
##         ####
###############
