############
##         #
#          #
# B B      #
#. &      .#
############